NOTE: BUBBLE TYPE ID in the game starts at 0 and not 1.
pleas add +1 to bubble template

var template_0 = [
	[0,0,0,0,0,0,0,0,0,0,0,0,0,0,0,0],
	[0,0,0,0,0,0,0,0,0,0,0,0,0,0,0,0],
	[0,0,0,0,0,0,0,0,0,0,0,0,0,0,0,0],
	[0,0,0,0,0,0,0,0,0,0,0,0,0,0,0,0],	
];

var level1_template = [
	[0,0,0,0,1,1,2,2,3,3,4,4,0,0,0,0],
	[0,0,0,0,1,1,2,2,3,3,4,0,0,0,0,0],
	[0,0,0,0,3,3,4,4,1,1,2,2,0,0,0,0],
	[0,0,0,0,3,4,4,1,1,2,2,0,0,0,0,0],	
];

var level2_template = [
	[0,0,0,0,2,2,2,2,2,2,2,2,0,0,0,0],
	[0,0,0,0,3,3,3,3,3,3,3,0,0,0,0,0],
	[0,0,0,0,1,1,1,1,1,1,1,0,0,0,0,0],
	[0,0,0,0,4,4,4,4,4,4,0,0,0,0,0,0],	
];

var level3_template = [
	[0,0,0,0,2,2,2,2,2,2,2,2,0,0,0,0],
	[0,0,0,0,3,3,3,3,3,3,3,0,0,0,0,0],
	[0,0,0,0,1,1,1,1,1,1,1,0,0,0,0,0],
	[0,0,0,0,4,4,4,4,4,4,0,0,0,0,0,0],	
];

var level4_tempplate= [
	[0,0,0,0,3,0,0,0,0,0,0,3,0,0,0,0],
	[0,0,0,0,1,2,3,4,1,2,3,0,0,0,0,0],
	[0,0,0,0,4,0,0,0,0,0,0,3,0,0,0,0],
	[0,0,0,0,3,2,1,1,3,4,0,0,0,0,0,0],	
];

var level5_template= [
	[0,0,0,0,3,3,0,0,0,0,3,3,0,0,0,0],
	[0,0,0,0,0,2,0,0,0,0,4,0,0,0,0,0],
	[0,0,0,0,1,0,0,0,0,2,0,0,0,0,0,0],
	[0,0,0,0,0,2,0,0,0,0,1,0,0,0,0,0],	
	[0,0,0,0,0,1,0,0,0,0,4,0,0,0,0,0],
	[0,0,0,0,3,0,0,0,0,3,0,0,0,0,0,0],
	[0,0,0,0,0,2,0,0,0,0,1,0,0,0,0,0],
];

var level6_template= = [
	[0,0,0,0,0,1,0,1,0,1,0,1,0,0,0,0],
	[0,0,0,0,2,0,2,0,2,0,2,0,0,0,0,0],
	[0,0,0,3,0,3,0,3,0,3,0,0,0,0,0,0],
	[0,0,4,0,4,0,4,0,4,0,0,0,0,0,0,0],	
	[0,0,0,2,0,1,0,3,0,0,0,0,0,0,0,0],
	[0,0,0,0,3,0,4,0,0,0,0,0,0,0,0,0],
	[0,0,0,0,0,0,0,0,0,0,0,0,0,0,0,0],
];

gamedata.generatelevels = function(width, height)
{
	var starIdx = (16/2) - (width/2);
	for(var y=0; y<height; y++){
		if( y > 0 ){
			var odd = y % 2;
			random = randomize();

			if(odd){
			
			}else{
			
			}
		}
	}
}


gamedata.preparelevels ()
{

	// level1
	LevelBase level_1;
	level_1.description =
	level_1.type = clearall;
	level_t.bubble template = level1_template 
	...
	...
	
	levellist.push(level_1);

}